11111
11011
10001
11011
11111
P0,0
k2,2