11111
10001
10101
10001
11111
P0,0
k2,2